team,wins,losses,ties,matches_played,goals_for,goals_against,goal_differential,goals_per_match,points,wp,owp,oowp,rpi,event_name,record
Chattanooga Red Wolves SC ECNL RL B09,0,2,0,2,0,11,-11,0.0,0,0.0,2.0,0.0,1.0,ECNL Regional League Boys Mid-America 2024-25,0-2-0
FC Alliance ECNL RL B09,0,2,0,2,0,3,-3,0.0,0,0.0,2.0,0.0,1.0,ECNL Regional League Boys Mid-America 2024-25,0-2-0
Alabama FC ECNL RL B09,2,0,0,2,2,0,2,1.0,6,1.0,0.0,2.0,0.75,ECNL Regional League Boys Mid-America 2024-25,2-0-0
Great Falls Reston Soccer Club ECNL RL B09,1,0,0,1,2,1,1,2.0,3,1.0,1.0,0.0,0.75,ECNL Regional League Boys Virginia 2024-25,1-0-0
Stafford Revolution ECNL RL B09,0,1,0,1,1,4,-3,1.0,0,0.0,2.0,-1.0,0.75,ECNL Regional League Boys Virginia 2024-25,0-1-0
Tennessee SC ECNL RL B09,2,0,0,2,12,0,12,6.0,6,1.0,0.0,2.0,0.75,ECNL Regional League Boys Mid-America 2024-25,2-0-0
AC Marin RL B09,2,0,1,3,6,4,2,2.0,7,0.67,0.67,0.75,0.69,ECNL Regional League Boys NorCal 2024-25,2-0-1
Burlingame SC RL B09,1,2,0,3,1,5,-4,0.33,3,0.33,1.0,0.42,0.69,ECNL Regional League Boys NorCal 2024-25,1-2-0
HTX ECNL RL B09 N,1,0,0,1,3,2,1,3.0,3,1.0,0.5,0.75,0.69,ECNL Regional League Boys Texas 2024-25,1-0-0
Seattle United ECNL RL B09,4,1,0,5,13,5,8,2.6,12,0.8,0.64,0.55,0.66,ECNL Regional League Boys Northwest 2024-25,4-1-0
FC Dallas Navy ECNL RL NTX B09,4,0,0,4,14,3,11,3.5,12,1.0,0.5,0.61,0.65,ECNL Regional League Boys North Texas 2024-25,4-0-0
3RSC ECNL RL B09,5,0,1,6,20,7,13,3.33,16,0.83,0.56,0.59,0.64,ECNL Regional League Boys Northwest 2024-25,5-0-1
West Side Alliance ECNL RL B09,1,0,1,2,6,4,2,3.0,4,0.5,0.75,0.5,0.62,ECNL Regional League Boys Texas 2024-25,1-0-1
Florida Elite ECNL RL B09,1,1,0,2,2,1,1,1.0,3,0.5,0.75,0.43,0.61,ECNL Regional League Boys Florida 2024-25,1-1-0
Kernow Storm FC ECNL RL NTX B09,3,1,0,4,20,2,18,5.0,9,0.75,0.62,0.46,0.61,ECNL Regional League Boys North Texas 2024-25,3-1-0
Concorde Fire Premier ECNL RL B09,3,0,0,3,10,2,8,3.33,9,1.0,0.31,0.67,0.57,ECNL Regional League Boys Southeast 2024-25,3-0-0
PacNW SC ECNL RL B09,3,2,0,5,14,8,6,2.8,9,0.6,0.59,0.5,0.57,ECNL Regional League Boys Northwest 2024-25,3-2-0
Albion SC Merced RL B09,2,0,1,3,10,4,6,3.33,7,0.67,0.5,0.58,0.56,ECNL Regional League Boys NorCal 2024-25,2-0-1
Eastside FC ECNL RL B09,3,2,0,5,12,9,3,2.4,9,0.6,0.52,0.56,0.55,ECNL Regional League Boys Northwest 2024-25,3-2-0
Coastal Rush ECNL RL B09,2,0,1,3,7,0,7,2.33,7,0.67,0.47,0.54,0.54,ECNL Regional League Boys Florida 2024-25,2-0-1
Dallas Texans Red ECNL RL NTX B09,2,0,2,4,7,5,2,1.75,8,0.5,0.62,0.4,0.54,ECNL Regional League Boys North Texas 2024-25,2-0-2
FL Premier FC - ECNL RL B09 NORTH,0,1,1,2,1,3,-2,0.5,1,0.0,0.75,0.66,0.54,ECNL Regional League Boys Florida 2024-25,0-1-1
NTX Celtic FC ECNL RL NTX B09,2,1,1,4,11,6,5,2.75,7,0.5,0.58,0.5,0.54,ECNL Regional League Boys North Texas 2024-25,2-1-1
Springs SC ECNL RL B09,1,1,0,2,3,3,0,1.5,3,0.5,0.67,0.31,0.54,ECNL Regional League Boys Florida 2024-25,1-1-0
Sting ECNL RL NTX B09,2,1,1,4,9,3,6,2.25,7,0.5,0.54,0.59,0.54,ECNL Regional League Boys North Texas 2024-25,2-1-1
FC Dallas White ECNL RL NTX B09,0,1,1,2,0,3,-3,0.0,1,0.0,0.83,0.48,0.53,ECNL Regional League Boys North Texas 2024-25,0-1-1
SC Surf ECNL RL B09,0,3,0,3,3,7,-4,1.0,0,0.0,1.0,0.12,0.53,ECNL Regional League Boys Southeast 2024-25,0-3-0
OK Energy FC ECNL RL B09,1,2,0,3,3,5,-2,1.0,3,0.33,1.0,-0.25,0.52,ECNL Regional League Boys Texas 2024-25,1-2-0
Turlock Academica Jrs RL B09,0,1,2,3,4,5,-1,1.33,2,0.0,0.75,0.56,0.52,ECNL Regional League Boys NorCal 2024-25,0-1-2
Mississippi Rush United ECNL RL B09,1,0,1,2,4,3,1,2.0,4,0.5,0.58,0.38,0.51,ECNL Regional League Boys Frontier 2024-25,1-0-1
Almaden FC RL B09,0,1,1,2,3,5,-2,1.5,1,0.0,0.75,0.5,0.5,ECNL Regional League Boys NorCal 2024-25,0-1-1
CHALLENGE UNITED EAST USC TX RL B09,1,0,0,1,2,0,2,2.0,3,1.0,0.5,0.0,0.5,ECNL Regional League Boys Texas 2024-25,1-0-0
Cavalry Black USC TX RL B09,0,0,1,1,2,2,0,2.0,1,0.0,1.0,0.0,0.5,ECNL Regional League Boys USC TX 2024-25,0-0-1
Dallas Texans RL B09,1,0,0,1,2,0,2,2.0,3,1.0,0.0,1.0,0.5,ECNL Regional League Boys North Texas 2024-25,1-0-0
FC Westlake ECNL RL B09,0,1,1,2,3,5,-2,1.5,1,0.0,0.75,0.5,0.5,ECNL Regional League Boys Texas 2024-25,0-1-1
XF ECNL RL B09,1,1,1,3,10,7,3,3.33,4,0.33,0.58,0.52,0.5,ECNL Regional League Boys Northwest 2024-25,1-1-1
DKSC ECNL RL NTX B09,2,1,1,4,5,7,-2,1.25,7,0.5,0.42,0.62,0.49,ECNL Regional League Boys North Texas 2024-25,2-1-1
South Carolina United ECNL RL B09,0,4,0,4,5,12,-7,1.25,0,0.0,0.78,0.41,0.49,ECNL Regional League Boys Southeast 2024-25,0-4-0
Columbia Premier SC ECNL RL B09,1,3,0,4,7,14,-7,1.75,3,0.25,0.61,0.47,0.48,ECNL Regional League Boys Northwest 2024-25,1-3-0
Concorde Fire Platinum ECNL RL B09,1,1,1,3,5,6,-1,1.67,4,0.33,0.5,0.6,0.48,ECNL Regional League Boys Southeast 2024-25,1-1-1
Spokane Shadow ECNL RL B09,3,3,0,6,18,14,4,3.0,9,0.5,0.43,0.55,0.48,ECNL Regional League Boys Northwest 2024-25,3-3-0
Avanti SA Grey ECNL RL NTX B09,0,4,0,4,0,15,-15,0.0,0,0.0,0.73,0.44,0.47,ECNL Regional League Boys North Texas 2024-25,0-4-0
BVBIA ECNL RL NTX B09,2,0,2,4,5,3,2,1.25,8,0.5,0.42,0.56,0.47,ECNL Regional League Boys North Texas 2024-25,2-0-2
FC Dallas Red ECNL RL NTX B09,1,2,0,3,3,8,-5,1.0,3,0.33,0.5,0.56,0.47,ECNL Regional League Boys North Texas 2024-25,1-2-0
FL Premier FC Black - ECNL RL B09 South,2,0,0,2,3,0,3,1.5,6,1.0,0.12,0.66,0.47,ECNL Regional League Boys Florida 2024-25,2-0-0
Florida Kraze ECNL-RL B09,1,1,1,3,3,4,-1,1.0,4,0.33,0.56,0.44,0.47,ECNL Regional League Boys Florida 2024-25,1-1-1
South Valley Chivas Academy RL B09,2,0,1,3,11,3,8,3.67,7,0.67,0.25,0.71,0.47,ECNL Regional League Boys NorCal 2024-25,2-0-1
Washington Premier ECNL RL B09,1,4,0,5,15,13,2,3.0,3,0.2,0.6,0.5,0.47,ECNL Regional League Boys Northwest 2024-25,1-4-0
CESA Triumph ECNL RL B09,0,3,1,4,2,8,-6,0.5,1,0.0,0.72,0.41,0.46,ECNL Regional League Boys Southeast 2024-25,0-3-1
Dallas Texans ECNL RL NTX B09,2,2,0,4,5,13,-8,1.25,6,0.5,0.4,0.53,0.46,ECNL Regional League Boys North Texas 2024-25,2-2-0
NTH-NASA ECNL RL B09,3,0,0,3,5,2,3,1.67,9,1.0,0.12,0.61,0.46,ECNL Regional League Boys Southeast 2024-25,3-0-0
Orlando City Lake Nona ECNL RL B09,2,2,0,4,3,7,-4,0.75,6,0.5,0.44,0.48,0.46,ECNL Regional League Boys Florida 2024-25,2-2-0
United Futbol Academy RL B09,3,1,1,5,9,5,4,1.8,10,0.6,0.4,0.44,0.46,ECNL Regional League Boys Southeast 2024-25,3-1-1
Sting Nebraska ECNL RL B09,1,2,0,3,4,9,-5,1.33,3,0.33,0.69,0.1,0.45,ECNL Regional League Boys Heartland 2024-25,1-2-0
Supreme FC ECNL RL B09,0,2,0,2,1,8,-7,0.5,0,0.0,0.96,-0.11,0.45,ECNL Regional League Boys Florida 2024-25,0-2-0
Palm Beach Gardens ECNL RL B09,1,0,0,1,3,2,1,3.0,3,1.0,0.0,0.75,0.44,ECNL Regional League Boys Florida 2024-25,1-0-0
SOLAR BLUE ECNL RL NTX B09,2,0,1,3,7,3,4,2.33,7,0.67,0.28,0.53,0.44,ECNL Regional League Boys North Texas 2024-25,2-0-1
GSA ECNL RL B09,2,3,0,5,7,13,-6,1.4,6,0.4,0.44,0.43,0.43,ECNL Regional League Boys Southeast 2024-25,2-3-0
Atlanta Fire United ECNL RL B09,3,0,1,4,13,4,9,3.25,10,0.75,0.12,0.71,0.42,ECNL Regional League Boys Southeast 2024-25,3-0-1
RISE SC - ECNL White RL B09,0,1,2,3,3,4,-1,1.0,2,0.0,0.75,0.17,0.42,ECNL Regional League Boys Texas 2024-25,0-1-2
FC United Iowa ECNL RL B09,2,0,1,3,10,2,8,3.33,7,0.67,0.25,0.46,0.41,ECNL Regional League Boys Heartland 2024-25,2-0-1
SOCA Elite - ECNL RL 09B,0,1,1,2,1,4,-3,0.5,1,0.0,1.0,-0.38,0.41,ECNL Regional League Boys Virginia 2024-25,0-1-1
South Orlando Soccer Club ECNL RL B09,0,2,1,3,0,3,-3,0.0,1,0.0,0.61,0.4,0.41,ECNL Regional League Boys Florida 2024-25,0-2-1
Renegades SC ECNL RL NTX B09,0,4,0,4,4,10,-6,1.0,0,0.0,0.6,0.4,0.4,ECNL Regional League Boys North Texas 2024-25,0-4-0
Florida Celtic Soccer Club ECNL RL B09,0,0,2,2,1,1,0,0.5,2,0.0,0.5,0.56,0.39,ECNL Regional League Boys Florida 2024-25,0-0-2
Florida West FC ECNL RL B09,0,1,1,2,4,5,-1,2.0,1,0.0,0.5,0.55,0.39,ECNL Regional League Boys Florida 2024-25,0-1-1
Tampa Bay United ECNL RL B09,0,0,4,4,1,1,0,0.25,4,0.0,0.56,0.44,0.39,ECNL Regional League Boys Florida 2024-25,0-0-4
CHALLENGE UNITED ECNL RL B09,1,0,1,2,6,3,3,3.0,4,0.5,0.25,0.5,0.38,ECNL Regional League Boys Texas 2024-25,1-0-1
FC Dallas ECNL RL B09,1,0,0,1,4,1,3,4.0,3,1.0,0.0,0.5,0.38,ECNL Regional League Boys North Texas 2024-25,1-0-0
Oklahoma Cosmos RL B09,0,0,2,2,3,3,0,1.5,2,0.0,0.5,0.5,0.38,ECNL Regional League Boys Frontier 2024-25,0-0-2
RISE SC - ECNL Navy RL B09,1,0,2,3,2,0,2,0.67,5,0.33,0.42,0.36,0.38,ECNL Regional League Boys Texas 2024-25,1-0-2
San Antonio City SC ECNL RL B09,0,0,2,2,0,0,0,0.0,2,0.0,0.5,0.5,0.38,ECNL Regional League Boys Texas 2024-25,0-0-2
Sporting Iowa ECNL-RL B09,3,0,1,4,13,1,12,3.25,10,0.75,0.15,0.48,0.38,ECNL Regional League Boys Heartland 2024-25,3-0-1
Albion Hurricanes FC ECNL RL B09,0,1,2,3,0,2,-2,0.0,2,0.0,0.58,0.31,0.37,ECNL Regional League Boys Texas 2024-25,0-1-2
SOLAR RED ECNL RL NTX B09,0,4,0,4,3,15,-12,0.75,0,0.0,0.5,0.49,0.37,ECNL Regional League Boys North Texas 2024-25,0-4-0
Avanti SA Blue ECNL RL NTX B09,1,1,2,4,4,4,0,1.0,5,0.25,0.38,0.45,0.36,ECNL Regional League Boys North Texas 2024-25,1-1-2
FC Dallas Blue ECNL RL NTX B09,1,2,1,4,3,4,-1,0.75,4,0.25,0.4,0.4,0.36,ECNL Regional League Boys North Texas 2024-25,1-2-1
Avanti SA White ECNL RL NTX B09,1,1,1,3,2,2,0,0.67,4,0.33,0.36,0.34,0.35,ECNL Regional League Boys North Texas 2024-25,1-1-1
FL Premier FC SWFL ECNL RL B09,3,0,1,4,6,2,4,1.5,10,0.75,0.12,0.43,0.35,ECNL Regional League Boys Florida 2024-25,3-0-1
SOLAR WHITE ECNL RL NTX B09,1,1,1,3,7,3,4,2.33,4,0.33,0.25,0.57,0.35,ECNL Regional League Boys North Texas 2024-25,1-1-1
Valley Surf RL B09,0,2,0,2,2,9,-7,1.0,0,0.0,0.62,0.17,0.35,ECNL Regional League Boys NorCal 2024-25,0-2-0
Gretna Elite Academy ECNL RL B09,0,2,1,3,2,12,-10,0.67,1,0.0,0.53,0.29,0.34,ECNL Regional League Boys Heartland 2024-25,0-2-1
Arkansas Comets FC ECNL RL B09,0,2,0,2,2,5,-3,1.0,0,0.0,0.67,-0.04,0.33,ECNL Regional League Boys Frontier 2024-25,0-2-0
Blitz Academy ECNL RL B09,2,2,0,4,8,7,1,2.0,6,0.5,0.25,0.33,0.33,ECNL Regional League Boys Frontier 2024-25,2-2-0
FC Prime ECNL RL B09,0,2,0,2,2,6,-4,1.0,0,0.0,0.75,-0.17,0.33,ECNL Regional League Boys Florida 2024-25,0-2-0
Snohomish United ECNL RL B09,0,5,0,5,3,35,-32,0.6,0,0.0,0.35,0.56,0.32,ECNL Regional League Boys Northwest 2024-25,0-5-0
Imperial Red USC TX RL B09,1,0,1,2,5,4,1,2.5,4,0.5,0.0,0.75,0.31,ECNL Regional League Boys USC TX 2024-25,1-0-1
Los Gatos United RL B09,1,2,0,3,3,5,-2,1.0,3,0.33,0.08,0.71,0.3,ECNL Regional League Boys NorCal 2024-25,1-2-0
Tupelo FC ECNL RL B09,0,1,1,2,2,4,-2,1.0,1,0.0,0.42,0.38,0.3,ECNL Regional League Boys Frontier 2024-25,0-1-1
Parkland SC ECNL RL B09,0,1,1,2,3,5,-2,1.5,1,0.0,0.42,0.31,0.29,ECNL Regional League Boys Florida 2024-25,0-1-1
FC Richmond  ECNL RL B09,1,0,1,2,3,2,1,1.5,4,0.5,0.0,0.62,0.28,ECNL Regional League Boys Virginia 2024-25,1-0-1
Florida Elite Tallahassee  ECNL RL B09,0,1,2,3,0,1,-1,0.0,2,0.0,0.28,0.54,0.28,ECNL Regional League Boys Florida 2024-25,0-1-2
Strikers ECNL RL B09,0,2,0,2,2,4,-2,1.0,0,0.0,1.0,-0.88,0.28,ECNL Regional League Boys Virginia 2024-25,0-2-0
Vision Soccer Academy Premier ECNL RL B09,0,3,1,4,0,12,-12,0.0,1,0.0,0.46,0.12,0.26,ECNL Regional League Boys Heartland 2024-25,0-3-1
AHFC SW USC TX RL B09,0,0,1,1,0,0,0,0.0,1,0.0,0.5,0.0,0.25,ECNL Regional League Boys Texas 2024-25,0-0-1
Beach FC (VA) ECNL RL B09,1,1,0,2,2,2,0,1.0,3,0.5,0.25,0.0,0.25,ECNL Regional League Boys Virginia 2024-25,1-1-0
Cape Coral Cyclones ECNL  RL B09,1,0,0,1,3,2,1,3.0,3,1.0,0.0,0.0,0.25,ECNL Regional League Boys Florida 2024-25,1-0-0
Eagles SC ECNL RL B09,1,0,0,1,1,0,1,1.0,3,1.0,0.0,0.0,0.25,ECNL Regional League Boys SoCal 2024-25,1-0-0
LV Heat Surf ECNL RL B09,1,0,0,1,4,0,4,4.0,3,1.0,0.0,0.0,0.25,ECNL Regional League Boys SoCal 2024-25,1-0-0
Legends FC USC TX RL B09,0,1,0,1,2,3,-1,2.0,0,0.0,0.5,0.0,0.25,ECNL Regional League Boys USC TX 2024-25,0-1-0
Lonestar SC ECNL RL B09,0,2,0,2,1,5,-4,0.5,0,0.0,0.5,0.0,0.25,ECNL Regional League Boys Texas 2024-25,0-2-0
Loudoun Soccer RL B09,1,0,0,1,1,0,1,1.0,3,1.0,0.0,0.0,0.25,ECNL Regional League Boys Virginia 2024-25,1-0-0
MAFC FC USC TX RL B09,0,0,1,1,0,0,0,0.0,1,0.0,0.5,0.0,0.25,ECNL Regional League Boys USC TX 2024-25,0-0-1
Oklahoma Celtic ECNL RL B09,0,1,1,2,2,5,-3,1.0,1,0.0,0.25,0.5,0.25,ECNL Regional League Boys Texas 2024-25,0-1-1
SAFC Black ECRL B09,0,1,1,2,0,5,-5,0.0,1,0.0,0.5,0.0,0.25,ECNL Regional League Boys Texas 2024-25,0-1-1
San Diego Surf ECNL RL B09 White,1,0,0,1,1,0,1,1.0,3,1.0,0.0,0.0,0.25,ECNL Regional League Boys SoCal 2024-25,1-0-0
Sporting Nebraska FC ECNL RL B09,2,1,0,3,10,3,7,3.33,6,0.67,-0.11,0.54,0.25,ECNL Regional League Boys Heartland 2024-25,2-1-0
Villarreal VA ECNL RL B09,1,0,0,1,3,0,3,3.0,3,1.0,0.0,0.0,0.25,ECNL Regional League Boys Virginia 2024-25,1-0-0
West Coast FC ECNL RL B09 2,1,0,0,1,3,2,1,3.0,3,1.0,0.0,0.0,0.25,ECNL Regional League Boys SoCal 2024-25,1-0-0
DCSC ECNL RL Metros B09,0,1,1,2,1,8,-7,0.5,1,0.0,0.5,-0.12,0.22,ECNL Regional League Boys Virginia 2024-25,0-1-1
HTX ECNL RL B09 S,1,0,1,2,6,1,5,3.0,4,0.5,-0.12,0.62,0.22,ECNL Regional League Boys Texas 2024-25,1-0-1
McLean Green ECNL RL B09,1,1,0,2,3,2,1,1.5,3,0.5,0.0,0.38,0.22,ECNL Regional League Boys Virginia 2024-25,1-1-0
Houstonians FC TX ECNL RL B09,0,0,2,2,0,0,0,0.0,2,0.0,0.12,0.62,0.21,ECNL Regional League Boys Texas 2024-25,0-0-2
SAFC Red ECRL B09,1,0,2,3,1,0,1,0.33,5,0.33,0.0,0.5,0.21,ECNL Regional League Boys Texas 2024-25,1-0-2
Arkansas Rising ECNL RL B09,2,0,0,2,6,3,3,3.0,6,1.0,-0.33,0.46,0.2,ECNL Regional League Boys Frontier 2024-25,2-0-0
BVBIA ECNL RL B09,2,0,0,2,9,1,8,4.5,6,1.0,-0.5,0.75,0.19,ECNL Regional League Boys North Texas 2024-25,2-0-0
DKSC ECNL RL B09,1,1,0,2,4,3,1,2.0,3,0.5,-0.25,0.75,0.19,ECNL Regional League Boys North Texas 2024-25,1-1-0
Doral Soccer Club ECNL RL B09,2,0,1,3,9,0,9,3.0,7,0.67,-0.33,0.61,0.15,ECNL Regional League Boys Florida 2024-25,2-0-1
Tulsa SC ECNL RL B09,0,2,0,2,1,10,-9,0.5,0,0.0,0.5,-0.38,0.15,ECNL Regional League Boys Texas 2024-25,0-2-0
VSA ECNL RL B09,1,0,1,2,5,1,4,2.5,4,0.5,0.0,0.12,0.15,ECNL Regional League Boys Virginia 2024-25,1-0-1
210 FC USC TX RL B09,0,0,2,2,0,0,0,0.0,2,0.0,0.0,0.5,0.12,ECNL Regional League Boys USC TX 2024-25,0-0-2
Arlington Soccer ECNL RL B09,2,0,0,2,6,2,4,3.0,6,1.0,-1.0,1.5,0.12,ECNL Regional League Boys Virginia 2024-25,2-0-0
VA Reign FC ECNL RL B09,2,0,0,2,5,1,4,2.5,6,1.0,-0.75,1.0,0.12,ECNL Regional League Boys Virginia 2024-25,2-0-0
Richmond Kickers ECNL RL B09,1,1,0,2,2,1,1,1.0,3,0.5,0.0,-0.12,0.1,ECNL Regional League Boys Virginia 2024-25,1-1-0
Dynamos USC TX RL B09,0,1,1,2,0,2,-2,0.0,1,0.0,0.0,0.25,0.06,ECNL Regional League Boys USC TX 2024-25,0-1-1
PWSI Courage ECNL RL B09,1,1,0,2,7,2,5,3.5,3,0.5,-0.25,0.25,0.06,ECNL Regional League Boys Virginia 2024-25,1-1-0
Beach FC ECNL RL B09,0,0,1,1,0,0,0,0.0,1,0.0,0.0,0.0,0.0,ECNL Regional League Boys SoCal 2024-25,0-0-1
Herndon ECNL RL B09,0,1,0,1,0,1,-1,0.0,0,0.0,0.0,0.0,0.0,ECNL Regional League Boys Virginia 2024-25,0-1-0
Houston Futsal USC TX RL B09,0,0,1,1,0,0,0,0.0,1,0.0,0.0,0.0,0.0,ECNL Regional League Boys USC TX 2024-25,0-0-1
Imperial Gray USC TX RL B09,0,0,1,1,0,0,0,0.0,1,0.0,0.0,0.0,0.0,ECNL Regional League Boys USC TX 2024-25,0-0-1
LA Breakers FC  ECNL RL B09,0,0,1,1,0,0,0,0.0,1,0.0,0.0,0.0,0.0,ECNL Regional League Boys SoCal 2024-25,0-0-1
LA Breakers FC  ECNL RL B09 LB,0,0,1,1,0,0,0,0.0,1,0.0,0.0,0.0,0.0,ECNL Regional League Boys SoCal 2024-25,0-0-1
LAFC So Cal ECNL RL B09,0,1,0,1,0,4,-4,0.0,0,0.0,0.0,0.0,0.0,ECNL Regional League Boys SoCal 2024-25,0-1-0
LSC  Nth B USC TX RL B09,0,0,1,1,0,0,0,0.0,1,0.0,0.0,0.0,0.0,ECNL Regional League Boys Texas 2024-25,0-0-1
Legends FC ECNL RL 2 B09,0,0,1,1,0,0,0,0.0,1,0.0,0.0,0.0,0.0,ECNL Regional League Boys SoCal 2024-25,0-0-1
Legends FC ECNL RL B09,0,0,1,1,0,0,0,0.0,1,0.0,0.0,0.0,0.0,ECNL Regional League Boys SoCal 2024-25,0-0-1
Legends FC San Diego ECNL RL B09,0,0,1,1,0,0,0,0.0,1,0.0,0.0,0.0,0.0,ECNL Regional League Boys SoCal 2024-25,0-0-1
Pateadores ECNL RL B09,0,0,1,1,0,0,0,0.0,1,0.0,0.0,0.0,0.0,ECNL Regional League Boys SoCal 2024-25,0-0-1
Pateadores ECNL RL B09 NB,0,0,1,1,0,0,0,0.0,1,0.0,0.0,0.0,0.0,ECNL Regional League Boys SoCal 2024-25,0-0-1
RISE SC USC TX RL B09,0,0,1,1,0,0,0,0.0,1,0.0,0.0,0.0,0.0,ECNL Regional League Boys Texas 2024-25,0-0-1
Rangers FC ECNL RL B09,0,0,1,1,0,0,0,0.0,1,0.0,0.0,0.0,0.0,ECNL Regional League Boys SoCal 2024-25,0-0-1
Rebels SC ECNL RL B09,0,1,0,1,0,1,-1,0.0,0,0.0,0.0,0.0,0.0,ECNL Regional League Boys SoCal 2024-25,0-1-0
SDSC Surf ECNL RL B09,0,0,1,1,0,0,0,0.0,1,0.0,0.0,0.0,0.0,ECNL Regional League Boys SoCal 2024-25,0-0-1
SG1 USC TX RL B09,0,0,1,1,0,0,0,0.0,1,0.0,0.0,0.0,0.0,ECNL Regional League Boys USC TX 2024-25,0-0-1
San Diego Surf ECNL RL B09 Blue,0,0,1,1,0,0,0,0.0,1,0.0,0.0,0.0,0.0,ECNL Regional League Boys SoCal 2024-25,0-0-1
Slammers FC Maroon ECNL RL B09,0,0,1,1,0,0,0,0.0,1,0.0,0.0,0.0,0.0,ECNL Regional League Boys SoCal 2024-25,0-0-1
Slammers FC White ECNL RL B09,0,0,1,1,0,0,0,0.0,1,0.0,0.0,0.0,0.0,ECNL Regional League Boys SoCal 2024-25,0-0-1
Sporting California USA  - ECNL RL B09,0,0,1,1,0,0,0,0.0,1,0.0,0.0,0.0,0.0,ECNL Regional League Boys SoCal 2024-25,0-0-1
Sporting California USA - ECNL RL B09 II,0,1,0,1,2,3,-1,2.0,0,0.0,0.0,0.0,0.0,ECNL Regional League Boys SoCal 2024-25,0-1-0
Vienna Youth Soccer ECNL RL B09,0,1,0,1,0,3,-3,0.0,0,0.0,0.0,0.0,0.0,ECNL Regional League Boys Virginia 2024-25,0-1-0
Virginia Valor FC ECNL RL B09,1,1,0,2,1,4,-3,0.5,3,0.5,-0.25,0.0,0.0,ECNL Regional League Boys Virginia 2024-25,1-1-0
Wellington ECNL RL B09,0,1,0,1,2,3,-1,2.0,0,0.0,0.0,0.0,0.0,ECNL Regional League Boys Florida 2024-25,0-1-0
West Coast FC ECNL RL B09,0,1,0,1,0,1,-1,0.0,0,0.0,0.0,0.0,0.0,ECNL Regional League Boys SoCal 2024-25,0-1-0
LMVSC - RL B09,0,2,0,2,0,2,-2,0.0,0,0.0,0.0,-0.38,-0.1,ECNL Regional League Boys Virginia 2024-25,0-2-0
Virginia United RL B09,1,1,0,2,1,2,-1,0.5,3,0.5,-0.5,0.0,-0.12,ECNL Regional League Boys Virginia 2024-25,1-1-0
